68380000
a0000000
44480140
48480000
0c186480
00186100
00187e00
8c086000
9c000000
