68380000
a0000000
44480140
48480000
0457e078
60084500
04105f88
44580000
48589600
04dfe000
68380000
2c104010
0c104480
30104010
00104580
00104180
00105e00
8c084000
9c000000
