68380000
44480000
48485000
0c000480
00001f00
80500000
80580004
80600008
48680400
8028000c
80300010
04094000
04116000
04198000
0421a000
4c000000
9c000000