68380000
48481800
0c000480
00001e80
80480000
80500004
80580008
48605000
0c492600
0c514600
0c596600
80612000
80692004
80712008
48780400
8029200c
80312010
54000000
50020600
50022680
50024700
50026780
58080000
54000000
50028600
5002a680
5002c700
5002e780
58100000
54000000
50030600
50032680
50034700
50036780
58180000
54000000
50038600
5003a680
5003c700
5003e780
58200000
4c000000
80614000
80694004
80714008
8029400c
80314010
54000000
50020600
50022680
50024700
50026780
58080000
54000000
50028600
5002a680
5002c700
5002e780
58100000
54000000
50030600
50032680
50034700
50036780
58180000
54000000
50038600
5003a680
5003c700
5003e780
58200000
4c000000
80616000
80696004
80716008
8029600c
80316010
54000000
50020600
50022680
50024700
50026780
58080000
54000000
50028600
5002a680
5002c700
5002e780
58100000
54000000
50030600
50032680
50034700
50036780
58180000
54000000
50038600
5003a680
5003c700
5003e780
58200000
4c000000
9c000000

