68380000
48085000
48105000
48185000
48200400
4c000000
9c000000